############################################################
#.....#.....#.....#.....#.....#.....#.....  #....#....#....#
#.....#.....%.....#.....%.....#.....%.....  #....#....#....#
#..@..#..!..%..!..#..!..%..!..#..!..%..!..  #....#....#....#
#.....#.....%.....#.....%.....#.....%.....  #....#....#....#
#.....#.....#.....#.....#.....#.....#.....  ################
##%%%###%%%###%%%###%%%###%%%###%%%###%%%#                 #
#.....#.....#.....#.....#.....#.....#.....                 #
#.....%.....#.....%.....#.....%.....%.....#.....%..........#
#..!..%..!..#..!..%..!..#..!..%..!..%..!..#..!..%..........#
#.....%.....#.....%.....#.....%.....%.....#.....%..........#
#.....#.....#.....#.....#.....#.....#.....#.....#..........#
##%%%#########%%%###%%%###############%%%###%%%##..........#
#.....#.....#.....#.....#.....#.....#.....#.....######%%%###
#.....%.....#.....#.....#.....%.....%.....%.....#..........#
#..!..%..!..#..!..#..!..#..!..%..!..%..!..%..!..#..........#
#.....%.....#.....#.....#.....%.....%.....%.....#..........#
#.....#.....#.....#.....#.....#.....#.....#.....#..........#
##########################%%%###############################
#..........................................................#
#..........................................................#
#..........................................................#
#..........................................................#
##############################%%%###########################
#..........................................................#
#..........................................................#
#                    .................                     #
#....................#%# #..*....# #%#.....................#
#..........................................................#
#.....!...............!.............!................!.....#
#..........................................................#
#..........................................................#
#####..####################..#..#########################..#
#............#...............#................#............#
#............#...............#................#............#
###########..#..############################..#..###########
#............#..................#.............#............#
#............#..................#.............#............#
#..###################..#########..#########################
#..............#..............#...................#........#
#..............#..............#...................#........#
###########..########################..##################..#
#............#.........................#..........#........#
#............#.........................#..........#........#
#######################..############..#..#########..#######
#............#...........#.............#..........#........#
#............#...........#.............#..........#........#
###########..#..################################..#######..#
#............#...........#.............#..........#........#
#............#...........#.............#..........#........#
#..###########..##########..############..##########..######
#............#...........#.............#...................#
#............#...........#.............#...................#
###########..##########..############..##########..#########
#..........................................................#
#..........................................................#
#...####################################################...#
#..........................................................#
#...........................x..............................#
############################################################