############################################################
#@..#....#...#   ..#...#.....#..............#....#....#....#
#.#.#..#.#...#   ....#...##.##.......!......#....#....#....#
#%#.#.##.#...%....#      ... #..............#....#....#....#
#.#.#.#..#...%....       . . #.......!......#....#....#....#
#.#...#.##...#   ........... #..............################
#.#####.#....##########%%####################..............#
#.......#....#........#..#.............#....%..............#
#.......#....#.###### #..# #...........#....#..............#
####%%###%%%%#.#....#....*.#...........#....#..............#
#.....##.....#.##. .#%#..###...........#....#..............#
#%######.#####..#. . .           ......#....#..!...........#
#%#..........#..#... .           ......#....#..............#
#%#.########. ..#.#....#...............#....############%%%#
#%#.#.# . ...#..#. ....#...............#....#..............#
#%#.#........#..#. ....#...............#....#..............#
#%###.# . ...#..#.##...#################%%%%#..............#
#%%%%.. .... #..#.%#........................#..............#
#################%######     ################..............#
#............#...............#..............%.....       ..#
#............#...............#..............%.....       ..#
#............#...............#..............%.....       ..#
#............#...............#..............%..............#
#............#...............#%%%###########################
#............#......!........#.............................#
#............#...............#.............................#
#............#...............####%##########################
#............%...............#.........#...%....#..........#
#............%...............#.........#...#....#..........#
#............#...............#.........#...#....#..........#
###%%%%##########      #%%%###.........#...#....#..........#
#............#...............#.........#...#....#..........#
#............#...............#.........#...#....#..........#
#..   ....!..#...............#.........#...#....%..........#
# .... ......#...............#.........%...#....#..........#
#... ..   ...#...............#.........#...#....#..........#
#.........  .#...............###############################
#.       ... #.............................#...............#
#............#.............................#...............#
#..... ...!..####################..........#...............#
#... ...........................#..........#...        ....#
#. .............................#..........#...        ....#
#...............................#..........#...        ....#
#... .....!..##############.....#..........#...............#
#..... ......#............#.....#..........#...............#
#............#......!.....#.....#..........#...............#
#.........!..#............#.....#..........#...............#
#............#..................#.....!....#...............#
#... ........#..................#..........#...............#
#.........!..#....!.............#..........#...............#
#............#..................#..........#...............#
#... ........#..................#..........#...............#
#.........!..#....###############..........#...............#
#............#.............................#...............#
#............#.............................#...............#
#.........!..#.............                %...............#
#............##############%%%%%%%%%%%%%%%%%...............#
#..........................................................#
#.........................................................x#
############################################################